{
	terrain: "__________________________________________________________________________:
			  __________________________________________________________________________:
			  __________________________________________________________________________:
			  __________________________________________________________________________:
			  __________________________________________________________________________:
			  __________________________________________________________________________:
			  __________________________________________________________________________:
			  __________________________________________________________________________:
			  __________________________________ZZZZ________________________________YYYY:
			  __________________________________AAAAZ____________________Z_______YYYYBBB:
			  __________Z_______________________AAAAA____________________Z_______BBBBBBB:
			  _________ZZZ______________________AAAAA___________________ZZ_______BBBBBBB:
			  ZZZZZZZZZZZZZZZZZZZZZZZZZZZZZZZZZZZZZZZZZZZZZZZZZZZZZZZZZZZZZZZZZZZYYYYYYY
			  ",
	units: [
		{ x: 1200, y: 360, limit: 300, class:"enemies.FlayerEnemy" },
		{ x: 1400, y: 354, class:"enemies.SprayerEnemy" },
		{ x: 1300, y: 100, limit: 40, class:"enemies.SwayerEnemy" },
		{ x: 1500, y: 170, limit: 60, class:"enemies.SwayerEnemy" },
		{ x: 400,  y: 100, class:"PowerUp", type:"OXIDE" },
		{ x: 800,  y: 225, class:"PowerUp", type:"OXIDE" },
		{ x: 600,  y: 100, class:"Cloud" }
	]
}